8 8 8 8 8 8 8 8 8 8 8 8 8 8 8 8
7 7 7 6 6 6 6 6 6 7 7 7 6 6 6 1
7 7 6 6 6 6 6 6 7 7 7 6 6 6 6 1
7 6 6 6 6 6 6 6 6 7 7 7 6 6 6 1
6 6 6 6 6 6 6 6 6 6 6 6 6 6 6 1
1 6 6 6 6 6 6 6 6 6 6 6 7 7 7 1
1 6 6 6 6 6 6 6 6 6 6 6 6 6 6 1
1 6 6 6 6 7 7 7 1 1 6 6 6 6 6 1
1 6 6 6 7 7 7 7 7 1 6 6 6 6 6 1
1 2 2 6 6 1 7 7 7 1 6 6 6 7 7 7 
1 2 2 6 6 1 1 1 1 1 1 7 7 7 1 1
8 8 8 8 8 8 8 8 8 8 8 8 8 8 8 8



