18 18 18 18 18 18 18 18 18 18 18 18 18 18 18 18 18 18 18 18 18 18 18 18 18 18 18 18 18 18 18 18 18 18 18 18 18 18 18 18 18 18 18 18 18 18 18 18 18 18 
18 18 18 18 18 18 18 18 18 18 18 18 18 18 19 18 18 18 18 18 18 18 18 18 18 18 18 18 18 18 18 18 18 18 18 18 18 18 18 18 18 18 18 18 18 18 18 18 18 18 
18 18 18 18 18 18 18 19 18 18 18 18 18 18 18 18 18 18 18 18 18 18 18 18 18 19 18 18 18 18 18 18 18 19 18 18 18 18 18 18 18 18 18 18 18 18 18 18 18 18 
18 18 18 18 19 18 18 18 18 18 18 19 18 18 18 18 18 18 19 18 18 18 18 18 18 18 18 19 18 18 18 18 18 18 18 18 18 18 18 18 18 19 18 18 18 18 18 18 18 18  
18 18 18 18 18 18 18 18 18 19 18 18 18 18 18 19 18 18 18 18 18 18 18 19 18 18 18 18 18 18 18 19 18 18 19 18 18 18 19 18 18 18 18 18 18 18 18 18 18 18 
18 18 18 18 18 18 18 18 18 18 18 18 18 18 18 18 18 18 18 18 18 19 18 18 18 18 18 18 18 19 18 18 18 18 18 18 19 18 18 18 18 18 18 19 18 18 18 18 18 18  
18 18 18 18 18 19 28 20 20 20 20 20 20 20 29 18 18 18 28 20 20 20 20 20 20 20 20 29 18 18 18 28 20 20 20 20 20 20 20 20 20 20 29 18 18 18 18 18 18 18 
18 18 18 18 18 18 25 15 50 50 50 50 50 15 25 20 20 20 27 15 10 10 11 10 10 10 10 25 20 20 20 27 15 10 35 33 33 33 33 33 33 36 23 18 18 19 18 18 18 18 
18 18 19 18 18 18 25 15 50 39 39 39 50 15 15 15 15 15 15 15 10 21 21 21 21 16 10 15 15 15 15 15 15 15 8 3 3 3 3 3 3 7 23 18 18 18 18 18 18 18
18 18 18 18 18 18 25 15 50 39 39 39 50 15 15 15 15 15 15 15 10 23 18 18 18 25 10 15 15 15 15 15 15 15 8 3 3 3 3 3 3 7 23 18 18 18 18 18 18 18 
18 18 18 19 18 18 25 15 50 39 39 39 50 15 15 15 15 15 15 15 10 23 18 18 18 25 11 15 15 15 15 15 15 15 8 3 3 3 3 3 3 7 23 18 19 18 18 18 18 18 
18 18 18 18 19 18 25 15 50 39 39 39 50 15 15 15 15 15 15 15 10 25 20 20 20 27 10 15 15 15 15 15 15 15 8 3 3 3 3 3 3 7 23 18 18 18 18 18 18 18 
18 18 18 18 18 18 25 15 50 50 39 50 50 15 15 15 15 15 15 15 11 10 35 33 36 10 10 15 15 15 15 15 15 15 37 5 5 6 3 4 5 38 23 19 18 18 18 18 18 18 
18 18 18 18 18 18 25 15 15 15 10 15 15 15 15 15 15 15 15 15 15 15 8 3 7 15 15 15 15 15 15 15 15 15 15 15 15 8 3 7 21 21 31 18 18 18 18 18 18 18 
18 18 18 18 19 18 25 15 15 15 10 15 15 15 15 15 15 15 15 15 15 15 8 3 7 15 15 15 15 15 15 15 15 15 15 15 15 8 3 7 23 18 18 18 18 19 18 18 18 18 
18 18 18 18 18 18 30 21 16 15 10 15 15 15 15 15 15 15 15 15 15 15 8 3 7 15 15 15 15 15 15 15 15 15 15 15 15 8 3 7 23 18 18 18 18 18 18 18 18 18 
18 18 18 18 18 18 18 18 25 15 10 15 15 15 15 15 15 15 15 15 15 15 8 3 7 15 15 15 15 15 15 15 15 15 15 15 15 8 3 7 23 18 18 18 18 18 19 18 18 18 
18 18 19 18 18 18 18 28 27 15 10 15 15 15 15 15 15 15 15 15 15 15 8 3 7 15 15 15 15 15 15 15 15 15 15 35 33 35 3 7 23 18 18 19 18 18 18 18 18 18 
18 18 18 18 18 18 18 25 10 10 10 15 15 15 15 15 15 15 15 15 15 15 8 3 7 15 15 15 15 15 15 15 15 15 15 8 3 3 3 7 23 18 18 18 18 18 18 18 18 18 
18 18 18 19 18 18 18 25 10 15 15 15 15 15 15 15 15 15 15 15 15 10 8 3 7 10 15 15 15 15 15 15 15 15 15 8 3 4 5 38 23 18 19 18 18 18 18 18 18 18 
18 18 18 18 18 18 18 25 10 15 15 15 10 35 33 33 33 33 33 33 33 33 35 3 32 33 33 33 33 33 33 33 33 33 33 35 3 7 10 15 23 18 18 18 18 18 18 18 18 18 
18 18 18 18 18 19 18 25 10 15 15 15 11 8 3 3 3 3 3 3 3 3 3 3 3 3 3 3 3 3 3 3 3 3 3 3 3 7 10 21 31 18 18 18 18 18 18 18 18 18 
18 18 18 18 18 18 19 25 10 10 15 15 10 37 5 5 5 5 5 5 5 5 6 3 4 5 5 5 5 5 5 5 5 5 5 6 3 7 10 23 18 19 18 18 18 18 18 18 18 18 
18 18 18 18 18 18 18 30 16 10 15 15 10 15 15 15 15 15 15 15 15 10 8 3 7 10 15 15 15 15 15 15 15 15 15 8 3 7 10 23 18 18 18 18 19 18 18 18 18 18 
18 18 18 18 18 18 18 18 25 10 15 15 10 15 15 15 15 15 15 15 15 15 8 3 7 15 15 15 15 15 15 15 15 15 15 8 3 7 11 23 18 18 18 18 18 18 18 18 18 18 
18 18 18 18 18 19 18 28 27 10 15 15 10 10 10 15 15 15 15 15 15 15 8 3 7 15 15 15 15 15 15 15 15 15 15 8 3 7 10 23 18 18 18 19 18 18 18 18 18 18 
18 18 18 18 18 18 18 25 10 10 15 15 15 15 10 15 15 15 15 15 15 15 8 3 7 15 15 15 15 15 15 15 15 15 15 8 3 7 10 23 18 18 18 18 18 18 18 18 18 18 
18 18 18 19 18 18 18 25 10 15 15 15 15 15 10 15 15 15 15 15 15 15 8 3 7 15 15 10 15 15 15 15 15 15 15 8 3 7 10 23 18 19 18 18 18 18 18 18 18 18 
18 18 18 18 18 18 18 25 10 15 15 15 15 15 10 15 15 15 15 15 15 15 8 3 7 15 15 15 15 15 10 15 15 15 15 8 3 7 10 23 18 18 18 18 18 18 18 18 18 18 
18 18 18 18 18 18 19 25 10 10 10 10 10 10 10 15 15 15 15 15 15 15 8 3 7 15 15 15 15 15 10 15 15 15 15 37 5 38 10 23 18 18 18 18 19 18 18 18 18 18 
18 18 18 18 18 18 18 25 10 10 11 10 10 10 10 15 15 15 15 15 15 15 8 3 7 15 15 15 15 15 15 15 15 15 15 15 10 15 21 31 18 18 19 18 18 18 18 18 18 18 
18 18 18 18 18 18 18 30 16 10 10 10 10 10 10 15 15 15 15 15 15 15 8 3 7 15 15 15 15 15 15 15 15 15 15 10 10 10 23 18 18 18 18 18 18 18 18 18 18 18 
18 18 18 18 18 19 18 18 25 10 10 10 10 11 10 15 15 15 15 15 15 15 8 3 7 15 15 15 15 15 15 15 15 15 15 10 10 10 23 18 18 18 18 18 18 18 19 18 18 18 
18 18 18 18 18 18 18 18 25 11 10 10 10 10 10 15 15 15 15 15 15 15 8 3 7 15 15 15 15 15 15 15 15 15 15 10 10 11 23 18 18 19 18 18 18 18 18 18 18 18 
18 18 18 18 18 18 18 18 25 10 10 10 10 10 10 15 15 15 15 15 15 15 8 3 7 15 15 15 15 15 15 15 15 15 15 10 10 10 23 18 18 18 18 18 18 18 18 18 18 18 
18 18 18 18 19 18 18 28 27 15 15 15 15 15 15 15 15 15 15 15 15 15 37 5 38 15 15 15 15 15 15 15 15 15 15 11 10 10 25 29 18 18 18 18 18 18 18 18 18 18 
18 18 18 18 18 18 18 25 15 15 15 15 15 15 15 15 15 15 15 10 10 10 10 10 10 10 10 15 15 15 15 15 15 15 10 10 10 10 10 25 29 18 18 18 19 18 18 18 18 18 
18 18 18 18 18 18 19 25 15 15 15 15 15 15 15 15 15 15 10 10 10 10 10 10 10 10 10 10 15 15 10 15 15 10 10 10 10 10 10 10 23 18 18 18 18 18 18 18 18 18 
18 18 18 18 18 18 18 25 10 15 15 15 15 15 15 15 15 15 10 11 10 10 10 10 10 11 10 10 15 15 15 15 10 10 10 10 10 11 10 10 23 18 19 18 18 18 18 18 18 18 
18 18 18 18 18 18 18 25 10 15 15 15 15 10 15 15 15 15 10 10 11 10 10 10 10 10 10 10 10 15 15 15 10 10 10 10 10 15 10 10 23 18 18 18 18 18 18 18 18 18 
18 18 19 18 18 18 18 25 10 15 15 15 15 15 15 15 15 15 10 10 10 10 10 10 10 10 10 10 10 10 10 10 10 10 15 10 10 10 10 10 23 18 18 18 18 19 18 18 18 18 
18 18 18 18 18 18 18 25 10 15 15 15 15 10 15 21 21 21 16 10 10 10 10 10 11 10 10 21 21 21 16 10 10 10 10 10 10 10 11 10 23 18 18 18 18 18 18 19 18 18 
18 18 18 18 18 18 18 25 15 15 15 15 15 15 21 31 18 18 30 16 10 10 10 10 10 10 21 31 18 18 25 10 10 15 10 10 15 10 10 10 23 18 18 18 18 18 18 18 18 18 
18 18 18 18 19 18 18 30 21 21 21 21 21 21 31 18 18 18 18 30 21 21 21 21 21 21 31 18 19 18 30 16 10 11 10 10 10 10 21 21 31 18 19 18 18 18 18 18 18 18 
18 18 18 18 18 18 18 18 18 18 18 18 18 18 18 18 18 18 19 18 18 18 18 18 18 18 18 18 18 18 18 30 21 21 21 21 21 21 31 18 18 18 18 18 18 18 19 18 18 18 
18 18 18 18 18 18 18 18 18 18 18 19 18 18 18 18 19 18 18 18 18 18 18 18 18 18 18 18 18 18 18 18 18 18 18 18 19 18 18 18 18 18 18 19 18 18 18 18 18 18 
18 18 18 18 18 18 19 18 18 18 18 18 18 18 18 18 18 18 18 18 18 18 18 18 19 18 18 18 18 19 18 18 18 18 18 18 18 18 18 18 18 18 18 18 18 18 18 18 18 18 
18 18 18 18 18 18 18 18 18 18 18 18 18 18 19 18 18 18 18 18 19 18 18 18 18 18 18 18 18 18 18 18 19 18 18 18 18 18 18 19 18 18 18 18 18 18 18 18 18 18 
18 18 18 18 18 18 18 18 18 18 18 18 18 18 18 18 18 18 18 18 18 18 18 18 18 18 18 19 18 18 18 18 18 18 18 18 18 18 18 18 18 18 18 18 18 19 18 18 18 18 
18 18 18 18 18 18 18 18 18 18 18 18 18 18 18 18 18 18 18 18 18 18 18 18 18 18 18 18 18 18 18 18 18 18 18 18 18 18 18 18 18 18 18 18 18 18 18 18 18 18 