18 18 18 18 18 18 18 18 18 18 18 18 18 18 18 18 18 18 18 18 18 18 18 18 18 18 18 18 18 18 18 18 18 18 18 18 18 18 18 18 18 18 18 18 18 18 18 18 18 18 
18 18 18 18 18 18 18 18 18 18 18 18 18 18 18 18 18 18 18 18 18 18 18 18 18 18 18 18 18 18 18 18 18 18 18 18 18 18 18 18 18 18 18 18 18 18 18 18 18 18 
18 18 18 18 18 18 18 18 18 18 18 18 18 18 18 18 18 18 18 18 18 18 18 18 18 18 18 18 18 18 18 18 18 18 18 18 18 18 18 18 18 18 18 18 18 18 18 18 18 18 
18 18 18 18 18 18 18 18 18 18 18 18 18 18 18 18 18 18 18 18 18 18 18 18 18 18 18 18 18 18 18 18 18 18 18 18 18 18 18 18 18 18 18 18 18 18 18 18 18 18 
18 18 18 18 18 18 18 18 18 18 18 18 18 18 18 18 18 18 18 18 18 18 18 18 18 18 18 18 18 18 18 18 18 18 18 18 18 18 18 18 18 18 18 18 18 18 18 18 18 18 
18 18 18 18 18 18 18 18 18 18 18 18 18 18 18 18 18 18 18 18 18 18 18 18 18 18 18 18 18 18 18 18 18 18 18 18 18 18 18 18 18 18 18 18 18 18 18 18 18 18 
18 18 18 18 18 18 18 18 18 18 18 18 18 18 18 18 18 18 18 18 18 18 18 18 18 18 18 18 18 18 18 18 18 18 18 18 18 18 18 18 18 18 18 18 18 18 18 18 18 18 
18 18 18 18 28 26 26 26 26 26 26 26 26 26 26 26 26 26 26 26 26 26 26 26 26 26 26 26 26 26 26 26 26 26 26 26 26 29 18 18 18 18 18 18 18 18 18 18 18 18 
18 18 18 18 24 16 16 16 16 16 16 16 16 16 16 16 16 16 16 16 16 16 16 16 16 16 16 16 16 16 16 16 16 16 16 16 16 23 18 18 18 18 18 18 18 18 18 18 18 18 
18 18 18 18 24 16 16 16 16 16 16 16 16 16 16 16 16 16 16 16 16 16 16 16 16 16 16 16 16 16 16 16 16 16 16 16 16 23 18 18 18 18 18 18 18 18 18 18 18 18 
18 18 18 18 24 16 16 16 16 16 16 16 16 16 16 16 16 16 16 16 16 16 16 16 16 16 16 16 16 16 16 16 16 16 16 16 16 23 18 18 18 18 18 18 18 18 18 18 18 18 
18 18 18 18 24 16 16 16 16 16 16 16 16 16 16 16 16 16 16 16 16 16 16 16 16 16 16 16 16 16 16 16 16 16 16 16 16 23 18 18 18 18 18 18 18 18 18 18 18 18 
18 18 18 18 24 16 16 16 16 16 16 16 16 16 16 16 16 16 16 16 16 16 16 16 16 16 16 16 16 16 16 16 16 16 16 16 16 23 18 18 18 18 18 18 18 18 18 18 18 18 
18 18 18 18 24 16 16 16 16 1 1 1 1 1 1 1 1 1 1 1 1 1 1 1 1 16 16 16 16 16 16 16 16 16 16 16 16 23 18 18 18 18 18 18 18 18 18 18 18 18 
18 18 18 18 24 16 16 16 16 1 1 1 1 1 1 1 1 1 1 1 1 1 1 1 16 16 16 16 16 16 16 16 16 16 16 16 16 23 18 18 18 18 18 18 18 18 18 18 18 18 
18 18 18 18 24 16 16 16 16 10 10 10 10 10 10 10 10 13 1 1 1 1 1 1 1 16 16 16 16 16 16 16 16 16 16 16 16 23 18 18 18 18 18 18 18 18 18 18 18 18 
18 18 18 18 24 16 16 16 33 3 3 3 3 3 3 3 3 9 10 10 10 10 10 10 10 13 16 16 16 16 16 16 16 16 16 16 16 23 18 18 18 18 18 18 18 18 18 18 18 18 
18 18 18 18 24 16 16 16 16 5 5 5 5 5 5 6 3 3 3 3 3 3 3 3 3 7 16 16 16 16 16 16 16 16 16 16 16 23 18 18 18 18 18 18 18 18 18 18 18 18 
18 18 18 18 24 16 16 1 16 16 16 1 1 1 1 14 5 5 5 5 5 5 6 3 3 7 16 16 16 16 16 16 16 16 16 16 16 25 26 26 26 26 26 26 26 26 26 26 29 18 
18 18 18 18 24 16 16 1 1 16 16 16 16 1 1 1 1 1 1 1 1 1 8 3 3 7 16 16 16 16 16 16 16 16 16 16 16 16 16 16 16 16 16 16 16 16 16 16 23 18 
18 18 18 18 24 16 1 16 16 16 16 1 1 1 1 1 1 1 1 1 1 1 8 3 4 15 16 16 16 16 16 16 16 16 16 16 16 16 16 16 16 16 16 16 16 16 16 16 23 18 
18 18 18 18 24 1 1 1 1 1 1 1 1 1 1 1 1 1 1 1 1 1 8 3 9 10 10 10 10 10 10 13 16 16 16 16 16 16 16 16 16 16 16 16 16 16 16 16 23 18 
18 18 18 28 27 1 1 1 1 1 1 1 1 1 1 1 1 1 1 1 1 1 8 3 3 3 3 3 3 3 3 7 16 16 16 16 16 16 16 16 16 16 16 16 16 16 16 16 23 18 
18 18 18 24 1 1 1 1 1 1 1 1 1 1 1 1 1 1 1 1 1 1 14 5 5 5 5 5 5 6 3 7 16 16 16 16 16 16 16 16 16 16 16 16 16 16 16 16 23 18 
18 18 18 24 12 10 10 10 10 10 10 10 10 10 10 10 10 10 10 13 1 1 1 1 1 1 1 1 1 8 3 7 16 16 16 16 16 16 16 16 16 16 16 16 16 16 16 16 23 18 
18 18 18 24 8 3 3 3 3 3 3 3 3 3 3 3 3 3 3 7 1 1 1 1 1 1 1 1 1 8 3 7 16 16 16 16 16 16 16 16 16 16 16 16 16 16 16 16 23 18 
18 18 18 24 8 3 3 3 3 3 3 3 3 3 3 3 3 3 3 7 1 1 1 1 1 1 1 1 1 8 3 7 16 16 16 16 16 16 16 16 16 16 16 16 16 16 16 16 23 18 
18 18 18 24 8 3 3 3 3 3 3 3 3 3 3 3 3 3 3 9 10 10 10 10 10 10 10 10 10 11 3 7 16 16 16 16 16 16 16 16 16 16 16 16 16 16 16 16 23 18 
18 18 18 24 8 3 3 3 3 3 3 3 3 3 3 3 3 3 3 3 3 3 3 3 3 3 3 3 3 3 3 7 16 16 16 16 16 16 16 16 16 16 16 16 16 16 16 16 23 18 
18 18 18 24 8 3 3 3 3 3 3 3 3 3 3 3 3 3 3 4 5 5 5 5 5 5 5 5 5 5 5 16 16 16 16 16 16 16 16 16 16 16 16 16 16 16 16 16 23 18 
18 18 18 24 8 3 3 3 3 3 3 3 3 3 3 3 3 3 3 7 16 16 16 16 16 16 16 16 16 16 1 16 1 1 1 1 1 1 1 1 1 1 1 16 16 16 16 16 23 18 
18 18 18 24 8 3 3 3 3 3 3 3 3 3 3 3 3 3 3 7 16 16 16 16 16 16 16 16 16 16 1 16 1 1 1 1 1 1 1 1 1 1 1 16 16 16 16 16 23 18 
18 18 18 24 14 5 5 5 5 5 5 5 5 5 5 5 5 5 5 15 16 16 16 16 16 16 16 16 16 16 1 16 1 1 1 1 1 1 1 1 1 1 1 16 16 16 16 16 23 18 
18 18 18 24 16 16 16 1 16 16 16 16 16 1 1 16 16 16 16 16 1 1 16 16 16 16 16 16 16 16 1 16 1 1 1 1 1 1 1 1 1 1 1 16 16 16 16 16 23 18 
18 18 18 24 16 16 16 1 16 16 16 16 16 1 1 16 16 16 16 16 1 1 16 16 16 16 16 16 16 16 1 16 1 1 1 1 1 1 1 1 1 1 1 16 16 16 16 16 23 18 
18 18 18 24 16 16 16 1 16 16 16 16 16 1 1 16 16 16 16 16 1 1 16 16 16 16 16 16 16 16 1 16 16 16 1 16 16 16 16 16 16 16 1 16 16 16 16 16 23 18 
18 18 18 24 16 16 16 1 16 16 16 16 16 1 1 16 16 1 1 1 1 1 1 16 16 16 16 16 16 16 1 16 16 16 1 16 16 16 16 16 16 16 37 16 16 16 16 16 23 18 
18 18 18 24 16 16 1 1 16 16 16 16 16 16 1 1 16 1 1 1 1 1 1 16 16 16 1 1 1 1 1 1 1 1 1 16 20 21 21 21 21 21 21 21 21 21 21 21 31 18 
18 18 18 24 16 16 1 1 1 16 1 16 1 1 1 1 16 1 1 1 1 1 1 16 16 16 16 1 1 1 1 1 1 1 1 16 23 18 18 18 18 18 18 18 18 18 18 18 18 18 
18 18 18 24 16 16 1 1 1 16 16 16 16 1 1 1 16 1 1 1 1 16 16 16 16 16 16 1 1 1 1 1 1 1 1 16 23 18 18 18 18 18 18 18 18 18 18 18 18 18 
18 18 18 24 16 16 16 16 16 16 16 16 16 16 16 16 16 16 16 16 16 16 16 16 16 16 16 16 16 16 16 16 16 16 16 16 23 18 18 18 18 18 18 18 18 18 18 18 18 18 
18 18 18 30 21 21 21 21 21 21 21 21 21 21 21 21 21 21 21 21 21 21 21 21 21 21 21 21 21 21 21 21 21 21 21 21 31 18 18 18 18 18 18 18 18 18 18 18 18 18 
18 18 18 18 18 18 18 18 18 18 18 18 18 18 18 18 18 18 18 18 18 18 18 18 18 18 18 18 18 18 18 18 18 18 18 18 18 18 18 18 18 18 18 18 18 18 18 18 18 18 
18 18 18 18 18 18 18 18 18 18 18 18 18 18 18 18 18 18 18 18 18 18 18 18 18 18 18 18 18 18 18 18 18 18 18 18 18 18 18 18 18 18 18 18 18 18 18 18 18 18 
18 18 18 18 18 18 18 18 18 18 18 18 18 18 18 18 18 18 18 18 18 18 18 18 18 18 18 18 18 18 18 18 18 18 18 18 18 18 18 18 18 18 18 18 18 18 18 18 18 18 
18 18 18 18 18 18 18 18 18 18 18 18 18 18 18 18 18 18 18 18 18 18 18 18 18 18 18 18 18 18 18 18 18 18 18 18 18 18 18 18 18 18 18 18 18 18 18 18 18 18 
18 18 18 18 18 18 18 18 18 18 18 18 18 18 18 18 18 18 18 18 18 18 18 18 18 18 18 18 18 18 18 18 18 18 18 18 18 18 18 18 18 18 18 18 18 18 18 18 18 18 
18 18 18 18 18 18 18 18 18 18 18 18 18 18 18 18 18 18 18 18 18 18 18 18 18 18 18 18 18 18 18 18 18 18 18 18 18 18 18 18 18 18 18 18 18 18 18 18 18 18 
18 18 18 18 18 18 18 18 18 18 18 18 18 18 18 18 18 18 18 18 18 18 18 18 18 18 18 18 18 18 18 18 18 18 18 18 18 18 18 18 18 18 18 18 18 18 18 18 18 18 
18 18 18 18 18 18 18 18 18 18 18 18 18 18 18 18 18 18 18 18 18 18 18 18 18 18 18 18 18 18 18 18 18 18 18 18 18 18 18 18 18 18 18 18 18 18 18 18 18 18 
