18 18 18 18 18 18 18 18 18 18 18 18 18 18 18 18 18 18 18 18 18 18 18 18 18 18 18 18 18 18 18 18 18 18 18 18 18 18 18 18 18 18 18 18 18 18 18 18 18 18 
18 18 18 18 18 18 18 18 18 18 18 18 18 18 18 18 18 18 18 18 18 18 18 18 18 18 18 18 18 18 18 18 18 18 18 18 18 18 18 18 18 18 18 18 18 18 18 18 18 18 
18 18 18 18 18 18 18 18 18 18 18 18 18 18 18 18 18 18 18 18 18 18 18 18 18 18 18 18 18 18 18 18 18 18 18 18 18 18 18 18 18 18 18 18 18 18 18 18 18 18 
18 18 18 18 18 18 18 18 18 18 18 18 18 18 18 18 18 18 18 18 18 18 18 18 18 18 18 18 18 18 18 18 18 18 18 18 18 18 18 18 18 18 18 18 18 18 18 18 18 18 
18 18 18 18 18 18 18 18 18 18 18 18 18 18 18 18 18 18 18 18 18 18 18 18 18 18 18 18 18 18 18 18 18 18 18 18 18 18 18 18 18 18 18 18 18 18 18 18 18 18 
18 18 18 18 18 18 18 18 18 18 18 18 18 18 18 18 18 18 18 18 18 18 18 18 18 18 18 18 18 18 18 18 18 18 18 18 18 18 18 18 18 18 18 18 18 18 18 18 18 18 
18 18 18 18 18 18 18 18 18 18 18 18 18 18 18 18 18 18 18 18 18 18 18 18 18 18 18 18 18 18 18 18 18 18 18 18 18 18 18 18 18 18 18 18 18 18 18 18 18 18 
18 18 18 18 18 18 18 18 18 18 18 18 18 18 18 18 18 18 18 18 18 18 18 18 18 18 18 18 18 18 18 18 18 18 18 18 18 18 18 18 18 18 18 18 18 18 18 18 18 18 
18 18 18 18 18 18 18 18 18 18 18 18 18 18 18 18 18 18 18 18 18 18 18 18 18 18 18 18 18 18 18 18 18 18 18 18 18 18 18 18 18 18 18 18 18 18 18 18 18 18 
18 18 18 18 18 18 18 18 18 18 18 18 18 18 18 18 18 18 18 18 18 18 18 18 18 18 18 18 18 18 18 18 18 18 18 18 18 18 18 18 18 18 18 18 18 18 18 18 18 18 
18 18 18 18 18 18 18 18 18 18 18 18 18 18 18 18 18 18 18 18 18 18 18 18 18 18 18 18 18 18 18 18 18 18 18 18 18 18 18 18 18 18 18 18 18 18 18 18 18 18 
18 18 18 18 18 18 18 18 18 18 18 18 18 18 18 18 18 18 18 18 18 18 18 18 18 18 18 18 18 18 18 18 18 18 18 18 18 18 18 18 18 18 18 18 18 18 18 18 18 18 
18 18 18 18 18 18 18 18 18 18 18 18 18 18 18 18 18 18 18 18 18 18 18 18 18 18 18 18 18 18 18 18 18 18 18 18 18 18 18 18 18 18 18 18 18 18 18 18 18 18 
18 18 18 18 18 18 18 18 18 18 18 18 18 18 18 18 18 18 18 18 18 18 18 18 18 18 18 18 18 18 18 18 18 18 18 18 18 18 18 18 18 18 18 18 18 18 18 18 18 18 
18 18 18 18 18 18 18 18 18 18 18 18 18 18 18 18 18 18 18 18 18 18 18 18 18 18 18 18 18 18 18 18 18 18 18 18 18 18 18 18 18 18 18 18 18 18 18 18 18 18 
18 18 18 18 28 26 26 26 26 26 26 26 26 26 26 26 26 26 26 26 26 26 26 26 26 26 26 26 26 26 26 26 26 26 26 29 18 18 18 18 18 18 18 18 18 18 18 18 18 18 
18 18 18 18 24 16 16 16 16 16 16 16 16 16 16 16 16 16 16 16 16 16 16 16 16 16 16 16 16 16 16 16 16 16 16 23 18 18 18 18 18 18 18 18 18 18 18 18 18 18 
18 18 18 18 24 16 16 16 16 16 16 16 16 16 16 16 16 16 16 16 16 16 16 16 16 16 16 16 16 16 16 1 1 1 1 23 18 18 18 18 18 18 18 18 18 18 18 18 18 18 
18 18 18 18 24 16 16 16 33 1 16 16 16 16 1 1 33 1 1 1 1 1 16 16 16 16 16 16 16 16 16 1 1 1 1 23 18 18 18 18 18 18 18 18 18 18 18 18 18 18 
18 18 18 18 24 16 16 16 1 1 2 1 1 1 1 1 1 1 1 1 1 1 1 1 16 16 16 16 16 16 16 1 1 1 1 23 18 18 18 18 18 18 18 18 18 18 18 18 18 18 
18 18 18 18 24 16 16 16 1 1 16 16 16 16 16 16 16 16 16 16 16 16 16 1 16 16 16 16 16 16 16 1 1 1 1 23 18 18 18 18 18 18 18 18 18 18 18 18 18 18 
18 18 18 18 24 16 16 16 1 1 16 16 16 16 16 16 16 16 16 1 1 1 16 1 1 1 1 1 1 1 1 1 1 1 1 23 18 18 18 18 18 18 18 18 18 18 18 18 18 18 
18 18 18 18 24 16 16 16 1 1 1 16 16 16 16 16 16 16 16 1 1 1 1 1 16 16 16 16 16 16 16 16 16 16 16 23 18 18 18 18 18 18 18 18 18 18 18 18 18 18 
18 18 18 18 24 16 16 16 1 1 1 16 16 16 16 16 16 16 16 16 16 16 16 1 16 16 16 16 16 16 16 16 16 16 16 23 18 18 18 18 18 18 18 18 18 18 18 18 18 18 
18 18 18 18 24 16 16 16 1 1 1 16 16 16 16 16 16 16 16 16 16 16 1 1 16 16 16 16 16 16 1 16 16 16 16 23 18 18 18 18 18 18 18 18 18 18 18 18 18 18 
18 18 18 18 24 16 16 16 1 1 1 1 16 16 16 16 16 16 16 16 16 1 1 1 1 1 1 1 1 1 1 1 16 16 16 25 26 26 26 26 26 29 18 18 18 18 18 18 18 18 
18 18 18 18 24 16 16 16 1 1 1 1 1 1 1 1 16 16 16 16 16 16 16 1 1 1 1 1 1 1 1 1 1 1 16 16 16 16 16 16 16 23 18 18 18 18 18 18 18 18 
18 18 18 18 24 16 16 16 1 1 16 16 16 16 1 1 1 1 1 1 1 16 16 16 16 16 16 16 16 16 16 16 1 1 1 1 1 1 1 1 16 23 18 18 18 18 18 18 18 18 
18 18 18 18 24 16 16 16 16 16 16 16 16 16 16 16 16 16 16 16 12 10 10 10 10 10 10 13 16 16 16 16 1 1 1 1 1 1 1 1 16 23 18 18 18 18 18 18 18 18 
18 18 18 18 24 16 16 16 16 16 16 16 16 1 1 1 1 1 16 16 8 3 3 3 3 3 3 9 10 10 10 10 16 16 16 16 16 16 16 16 16 23 18 18 18 18 18 18 18 18 
18 18 18 18 24 16 16 16 16 16 16 16 1 1 1 1 1 1 1 16 8 3 3 3 3 3 3 3 3 3 3 3 9 10 10 10 10 10 10 10 13 23 18 18 18 18 18 18 18 18 
18 18 18 18 24 16 16 16 16 16 16 16 1 1 1 1 1 1 16 16 8 3 3 3 3 3 3 3 3 3 3 3 3 3 3 3 3 3 3 3 7 23 18 18 18 18 18 18 18 18 
18 18 18 18 24 16 16 16 16 16 16 16 16 1 16 16 16 16 16 16 8 3 3 3 3 3 3 3 3 3 3 3 3 3 4 5 5 5 6 3 7 23 18 18 18 18 18 18 18 18 
18 18 18 18 30 21 21 21 21 22 16 16 16 1 1 16 16 16 16 16 8 3 3 3 3 3 3 3 3 3 3 3 3 3 7 16 16 16 8 3 7 23 18 18 18 18 18 18 18 18 
18 18 18 18 18 18 18 18 18 24 16 16 16 33 1 16 16 16 16 16 8 3 3 3 3 3 3 3 3 3 3 3 3 3 7 16 16 16 8 3 7 23 18 18 18 18 18 18 18 18 
18 18 18 18 18 18 18 18 18 24 16 16 16 1 1 16 16 16 16 16 8 3 3 3 3 3 3 3 3 3 3 3 3 3 7 16 16 16 8 3 7 23 18 18 18 18 18 18 18 18 
18 18 18 18 18 18 18 18 18 24 16 16 16 16 16 16 16 16 16 16 8 3 3 3 3 3 3 3 3 3 3 3 3 3 7 16 16 16 8 3 7 23 18 18 18 18 18 18 18 18 
18 18 18 18 18 18 18 18 18 24 16 16 16 16 16 16 16 16 16 16 8 3 3 3 3 3 3 3 3 3 3 3 3 3 7 16 16 16 14 5 15 23 18 18 18 18 18 18 18 18 
18 18 18 18 18 18 18 18 18 24 16 16 16 16 16 16 16 16 16 16 14 5 5 5 5 5 5 5 5 5 5 5 5 5 15 1 16 16 16 16 16 23 18 18 18 18 18 18 18 18 
18 18 18 18 18 18 18 18 18 24 16 16 16 16 16 16 16 16 16 16 16 16 16 16 16 16 16 16 16 16 16 16 16 16 16 1 1 1 16 16 16 23 18 18 18 18 18 18 18 18 
18 18 18 18 18 18 18 18 18 24 16 16 16 16 16 16 16 16 16 16 16 16 16 16 16 16 16 16 16 16 16 16 16 16 16 1 33 1 16 16 16 23 18 18 18 18 18 18 18 18 
18 18 18 18 18 18 18 18 18 24 16 16 16 16 16 16 16 16 16 16 16 16 16 16 16 16 16 16 16 16 16 16 16 16 16 1 37 1 16 16 16 23 18 18 18 18 18 18 18 18 
18 18 18 18 18 18 18 18 18 30 21 21 21 21 21 21 21 21 21 21 21 21 21 21 21 21 21 21 21 21 21 21 21 21 21 21 21 21 21 21 21 31 18 18 18 18 18 18 18 18 
18 18 18 18 18 18 18 18 18 18 18 18 18 18 18 18 18 18 18 18 18 18 18 18 18 18 18 18 18 18 18 18 18 18 18 18 18 18 18 18 18 18 18 18 18 18 18 18 18 18 
18 18 18 18 18 18 18 18 18 18 18 18 18 18 18 18 18 18 18 18 18 18 18 18 18 18 18 18 18 18 18 18 18 18 18 18 18 18 18 18 18 18 18 18 18 18 18 18 18 18 
18 18 18 18 18 18 18 18 18 18 18 18 18 18 18 18 18 18 18 18 18 18 18 18 18 18 18 18 18 18 18 18 18 18 18 18 18 18 18 18 18 18 18 18 18 18 18 18 18 18 
18 18 18 18 18 18 18 18 18 18 18 18 18 18 18 18 18 18 18 18 18 18 18 18 18 18 18 18 18 18 18 18 18 18 18 18 18 18 18 18 18 18 18 18 18 18 18 18 18 18 
18 18 18 18 18 18 18 18 18 18 18 18 18 18 18 18 18 18 18 18 18 18 18 18 18 18 18 18 18 18 18 18 18 18 18 18 18 18 18 18 18 18 18 18 18 18 18 18 18 18 
18 18 18 18 18 18 18 18 18 18 18 18 18 18 18 18 18 18 18 18 18 18 18 18 18 18 18 18 18 18 18 18 18 18 18 18 18 18 18 18 18 18 18 18 18 18 18 18 18 18 
18 18 18 18 18 18 18 18 18 18 18 18 18 18 18 18 18 18 18 18 18 18 18 18 18 18 18 18 18 18 18 18 18 18 18 18 18 18 18 18 18 18 18 18 18 18 18 18 18 18 
